<div>backen</div>	<div>buk</div><div>hat gebacken</div><div><br /></div><div>печь</div>
<div>fahren</div>	<div>fuhr</div><div>ist/hat gefahren</div><div><br /></div><div>ехать</div>
<div>fressen</div>	<div>fraß</div><div>hat gefressen</div><div><br /></div><div>жрать</div>
<div>gelingen</div>	<div>gelang</div><div>ist gelungen</div><div><br /></div><div>удаваться</div>
<div>greifen</div>	<div>griff</div><div>hat gegriffen</div><div><br /></div><div>хватать</div>
<div>kennen</div>	<div>kannte</div><div>hat gekannt</div><div><br /></div><div>знать</div>
<div>leihen</div>	<div>lieh</div><div>hat geliehen</div><div><br /></div><div>одалживать</div>
<div>lügen</div>	<div>log</div><div>hat gelogen</div><div><br /></div><div>лгать</div>
<div>nehmen</div>	<div>nahm</div><div>hat genommen</div><div><br /></div><div>брать</div>
<div>pflegen</div>	<div>pflegte(pflog)</div><div>hat gepflegt (gepflogen)</div><div><br /></div><div>ухаживать;иметьобыкновение</div>
<div>reißen</div>	<div>riß</div><div>ist/hat gerissen</div><div><br /></div><div>рвать</div>
<div>schelten</div>	<div>schalt</div><div>hat gescholten</div><div><br /></div><div>бранить</div>
<div>schlafen</div>	<div>schlief</div><div>hat geschlafen</div><div><br /></div><div>спать</div>
<div>schwimmen</div>	<div>schwamm</div><div>ist/hat geschwommen</div><div><br /></div><div>плавать</div>
<div>streichen</div>	<div>strich</div><div>hat gestrichen</div><div><br /></div><div>гладить</div>
<div>treiben</div>	<div>trieb</div><div>ist/hat getrieben</div><div><br /></div><div>гнать</div>
<div>weben</div>	<div>webte(wob)</div><div>hat gewebt (gewoben)</div><div><br /></div><div>ткать</div>
<div>weisen</div>	<div>wies</div><div>hat gewiesen</div><div><br /></div><div>указывать</div>
<div>werden</div>	<div>wurde</div><div>ist geworden</div><div><br /></div><div>становиться</div>
<div>wissen</div>	<div>wußte</div><div>hat gewußt</div><div><br /></div><div>знать</div>
<div>erkiesen</div>	<div>erkor</div><div>hat erkoren</div><div><br /></div><div>избирать</div>
<div>gewinnen</div>	<div>gewann</div><div>hat gewonnen</div><div><br /></div><div>добывать</div>
<div>hauen</div>	<div>hieb</div><div>hat gehauen</div><div><br /></div><div>рубить</div>
<div>meiden</div>	<div>mied</div><div>hat gemieden</div><div><br /></div><div>избегать</div>
<div>vergessen</div>	<div>vergaß</div><div>hat vergessen</div><div><br /></div><div>забывать</div>
<div>binden</div>	<div>band</div><div>hat gebunden</div><div><br /></div><div>завязывать</div>
<div>fangen</div>	<div>fing</div><div>hat gefangen</div><div><br /></div><div>ловить</div>
<div>geben</div>	<div>gab</div><div>hat gegeben</div><div><br /></div><div>давать</div>
<div>raten</div>	<div>riet</div><div>hat geraten</div><div><br /></div><div>советовать</div>
<div>schlingen</div>	<div>schlang</div><div>hat geschlungen</div><div><br /></div><div>обвивать</div>
<div>sprechen</div>	<div>sprach</div><div>hat gesprochen</div><div><br /></div><div>говорить</div>
<div>wägen</div>	<div>wog</div><div>hat gewogen</div><div><br /></div><div>взвешивать</div>
<div>wenden</div>	<div>wandte</div><div>hat gewandt</div><div><br /></div><div>поворачивать</div>
<div>wiegen</div>	<div>wog</div><div>hat gewogen</div><div><br /></div><div>взвешивать</div>
<div>laufen</div>	<div>lief</div><div>ist gelaufen</div><div><br /></div><div>бегать</div>
<div>schrecken</div>	<div>schrak</div><div>hat geschrocken</div><div><br /></div><div>пугаться</div>
<div>schreiten</div>	<div>schritt</div><div>ist geschritten</div><div><br /></div><div>шагать</div>
<div>fallen</div>	<div>fiel</div><div>ist gefallen</div><div><br /></div><div>падать</div>
<div>gebären</div>	<div>gebar</div><div>ist/hat geboren</div><div><br /></div><div>родить</div>
<div>heben</div>	<div>hob</div><div>hat gehoben</div><div><br /></div><div>поднимать</div>
<div>reiten</div>	<div>ritt</div><div>ist/hat geritten</div><div><br /></div><div>ездитьверхом</div>
<div>scheiden</div>	<div>schied</div><div>ist/hat geschieden</div><div><br /></div><div>отделять</div>
<div>schleichen</div>	<div>schlich</div><div>ist geschlichen</div><div><br /></div><div>подкрадываться</div>
<div>sehen</div>	<div>sah</div><div>hat gesehen</div><div><br /></div><div>видеть</div>
<div>sitzen</div>	<div>saß</div><div>hat gesessen</div><div><br /></div><div>сидеть</div>
<div>steigen</div>	<div>stieg</div><div>ist gestiegen</div><div><br /></div><div>подниматься</div>
<div>bieten</div>	<div>bot</div><div>hat geboten</div><div><br /></div><div>предлагать</div>
<div>erbleichen</div>	<div>erbleichte(erblich)</div><div>ist erbleicht (erblichen)</div><div><br /></div><div>бледнеть</div>
<div>flechten</div>	<div>flocht</div><div>hat geflochten</div><div><br /></div><div>плести</div>
<div>gedeihen</div>	<div>gedieh</div><div>ist gediehen</div><div><br /></div><div>преуспевать, расти</div>
<div>glimmen</div>	<div>glomm</div><div>hat geglommen</div><div><br /></div><div>тлеть</div>
<div>haben</div>	<div>hatte</div><div>hat gehabt</div><div><br /></div><div>иметь</div>
<div>klingen</div>	<div>klang</div><div>hat geklungen</div><div><br /></div><div>звенеть</div>
<div>scheinen</div>	<div>schien</div><div>hat geschienen</div><div><br /></div><div>светить</div>
<div>speien</div>	<div>spie</div><div>hat gespien</div><div><br /></div><div>плевать</div>
<div>fliehen</div>	<div>floh</div><div>ist geflohen</div><div><br /></div><div>бежать</div>
<div>liegen</div>	<div>lag</div><div>hat gelegen</div><div><br /></div><div>лежать</div>
<div>rennen</div>	<div>rannte</div><div>ist gerannt</div><div><br /></div><div>бежать</div>
<div>ringen</div>	<div>rang</div><div>hat gerungen</div><div><br /></div><div>выжимать</div>
<div>genesen</div>	<div>genas</div><div>ist genesen</div><div><br /></div><div>выздоравливать</div>
<div>heißen</div>	<div>hieß</div><div>hat geheißen</div><div><br /></div><div>называться</div>
<div>nennen</div>	<div>nannte</div><div>hat genannt</div><div><br /></div><div>называть</div>
<div>schaffen</div>	<div>schuf</div><div>hat geschaffen</div><div><br /></div><div>создавать</div>
<div>schneiden</div>	<div>schnitt</div><div>hat geschnitten</div><div><br /></div><div>резать</div>
<div>befehlen</div>	<div>befahl</div><div>hat befohlen</div><div><br /></div><div>приказывать</div>
<div>bringen</div>	<div>brachte</div><div>hat gebracht</div><div><br /></div><div>приносить</div>
<div>kommen</div>	<div>kam</div><div>ist gekommen</div><div><br /></div><div>приходить</div>
<div>melken</div>	<div>melkte(molk)</div><div>hat gemelkt (gemolken)</div><div><br /></div><div>доить</div>
<div>pfeifen</div>	<div>pfiff</div><div>hat gepfiffen</div><div><br /></div><div>свистеть</div>
<div>rufen</div>	<div>rief</div><div>hat gerufen</div><div><br /></div><div>кричать, звать</div>
<div>schieben</div>	<div>schob</div><div>hat geschoben</div><div><br /></div><div>двигать</div>
<div>schinden</div>	<div>schund</div><div>hat geschunden</div><div><br /></div><div>сдиратьшкуру</div>
<div>schreien</div>	<div>schrie</div><div>hat geschrien</div><div><br /></div><div>кричать</div>
<div>sterben</div>	<div>starb</div><div>ist gestorben</div><div><br /></div><div>умирать</div>
<div>zeihen</div>	<div>zieh</div><div>hat geziehen</div><div><br /></div><div>уличать</div>
<div>zwingen</div>	<div>zwang</div><div>hat gezwungen</div><div><br /></div><div>принуждать</div>
<div>empfehlen</div>	<div>empfahl</div><div>hat empfohlen</div><div><br /></div><div>рекомендовать</div>
<div>bewegen</div>	<div>bewog</div><div>hat bewogen</div><div><br /></div><div>склонять, побуждать</div>
<div>dreschen</div>	<div>drosch(drasch)</div><div>hat gedroschen</div><div><br /></div><div>молотить</div>
<div>kriechen</div>	<div>kroch</div><div>ist gekrochen</div><div><br /></div><div>ползать</div>
<div>lassen</div>	<div>ließ</div><div>hat gelassen</div><div><br /></div><div>велеть, заставлять, оставлять</div>
<div>müssen</div>	<div>mußte</div><div>hat gemußt</div><div><br /></div><div>долженствовать</div>
<div>schweigen</div>	<div>schwieg</div><div>hat geschwiegen</div><div><br /></div><div>молчать</div>
<div>sollen</div>	<div>sollte</div><div>hat gesollt</div><div><br /></div><div>долженствовать</div>
<div>stechen</div>	<div>stach</div><div>hat gestochen</div><div><br /></div><div>колоть</div>
<div>stoßen</div>	<div>stieß</div><div>ist/hat gestoßen</div><div><br /></div><div>толкать</div>
<div>tun</div>	<div>tat</div><div>hat getan</div><div><br /></div><div>делать</div>
<div>brechen</div>	<div>brach</div><div>ist/hat gebrochen</div><div><br /></div><div>ломать</div>
<div>denken</div>	<div>dachte</div><div>hat gedacht</div><div><br /></div><div>думать</div>
<div>frieren</div>	<div>fror</div><div>hat gefroren</div><div><br /></div><div>замерзать</div>
<div>helfen</div>	<div>half</div><div>hat geholfen</div><div><br /></div><div>помогать</div>
<div>sinnen</div>	<div>sann</div><div>hat gesonnen</div><div><br /></div><div>думать</div>
<div>trügen</div>	<div>trog</div><div>hat getrogen</div><div><br /></div><div>обманывать</div>
<div>dingen</div>	<div>dingte</div><div>hat gedungen</div><div><br /></div><div>нанимать</div>
<div>stinken</div>	<div>stank</div><div>hat gestunken</div><div><br /></div><div>вонять</div>
<div>bitten</div>	<div>bat</div><div>hat gebeten</div><div><br /></div><div>просить</div>
<div>dringen</div>	<div>drang</div><div>ist/hat gedrungen</div><div><br /></div><div>проникать</div>
<div>dünken</div>	<div>dünkte(deuchte)</div><div>hat gedünkt (gedeucht)</div><div><br /></div><div>воображать</div>
<div>gären</div>	<div>gor</div><div>ist gegoren</div><div><br /></div><div>бродить</div>
<div>gelten</div>	<div>galt</div><div>hat gegolten</div><div><br /></div><div>стоить</div>
<div>geschehen</div>	<div>geschah</div><div>ist geschehen</div><div><br /></div><div>происходить</div>
<div>gleiten</div>	<div>glitt</div><div>ist geglitten</div><div><br /></div><div>скользить</div>
<div>stehen</div>	<div>stand</div><div>hat gestanden</div><div><br /></div><div>стоять</div>
<div>streiten</div>	<div>stritt</div><div>hat gestritten</div><div><br /></div><div>спорить</div>
<div>werfen</div>	<div>warf</div><div>hat geworfen</div><div><br /></div><div>бросать</div>
<div>bersten</div>	<div>barst</div><div>ist geborsten</div><div><br /></div><div>лопнуть</div>
<div>graben</div>	<div>grub</div><div>hat gegraben</div><div><br /></div><div>копать</div>
<div>kneifen</div>	<div>kniff</div><div>hat gekniffen</div><div><br /></div><div>щипать</div>
<div>schließen</div>	<div>schloß</div><div>hat geschlossen</div><div><br /></div><div>запирать</div>
<div>schnauben</div>	<div>schnaubte(schnob)</div><div>hat geschnaubt (geschnoben)</div><div><br /></div><div>сопеть</div>
<div>sieden</div>	<div>sott(siedete)</div><div>hat gesotten (gesiedet)</div><div><br /></div><div>кипятить, кипеть</div>
<div>triefen</div>	<div>trifte(troff)</div><div>hat getrieft (getroffen)</div><div><br /></div><div>капать</div>
<div>braten</div>	<div>briet</div><div>hat gebraten</div><div><br /></div><div>жарить</div>
<div>brennen</div>	<div>brannte</div><div>hat gebrannt</div><div><br /></div><div>гореть</div>
<div>halten</div>	<div>hielt</div><div>hat gehalten</div><div><br /></div><div>держать</div>
<div>leiden</div>	<div>litt</div><div>hat gelitten</div><div><br /></div><div>терпеть</div>
<div>messen</div>	<div>maß</div><div>hat gemessen</div><div><br /></div><div>мерить</div>
<div>reiben</div>	<div>rieb</div><div>hat gerieben</div><div><br /></div><div>тереть</div>
<div>scheren</div>	<div>schor</div><div>hat geschoren</div><div><br /></div><div>стричь</div>
<div>schießen</div>	<div>schoß</div><div>hat geschossen</div><div><br /></div><div>стрелять</div>
<div>stecken</div>	<div>stak(steckte)</div><div>hat gesteckt</div><div><br /></div><div>торчать</div>
<div>stehlen</div>	<div>stahl</div><div>hat gestohlen</div><div><br /></div><div>воровать</div>
<div>verderben</div>	<div>verdarb</div><div>ist/hat verdorben</div><div><br /></div><div>портить</div>
<div>verlieren</div>	<div>verlor</div><div>hat verloren</div><div><br /></div><div>терять</div>
<div>werben</div>	<div>warb</div><div>hat geworben</div><div><br /></div><div>вербовать</div>
<div>beißen</div>	<div>biß</div><div>hat gebissen</div><div><br /></div><div>кусать</div>
<div>genießen</div>	<div>genoss</div><div>hat genossen</div><div><br /></div><div>наслаждаться, пользоваться</div>
<div>hängen</div>	<div>hing</div><div>hat gehangen</div><div><br /></div><div>висеть</div>
<div>löschen</div>	<div>losch</div><div>hat geloschen</div><div><br /></div><div>гаснуть</div>
<div>preisen</div>	<div>pries</div><div>hat gepriesen</div><div><br /></div><div>восхвалять</div>
<div>saugen</div>	<div>sog</div><div>hat gesogen</div><div><br /></div><div>сосать</div>
<div>schreiben</div>	<div>schrieb</div><div>hat geschrieben</div><div><br /></div><div>писать</div>
<div>senden</div>	<div>sandte</div><div>hat gesandt</div><div><br /></div><div>посылать</div>
<div>stieben</div>	<div>stob</div><div>ist gestoben</div><div><br /></div><div>рассеиваться</div>
<div>tragen</div>	<div>trug</div><div>hat getragen</div><div><br /></div><div>носить</div>
<div>verdrießen</div>	<div>verdross</div><div>hat verdrossen</div><div><br /></div><div>досаждать</div>
<div>wachsen</div>	<div>wuchs</div><div>ist gewachsen</div><div><br /></div><div>расти</div>
<div>blasen</div>	<div>blies</div><div>hat geblasen</div><div><br /></div><div>дуть</div>
<div>bleiben</div>	<div>blieb</div><div>ist geblieben</div><div><br /></div><div>оставаться</div>
<div>essen</div>	<div>aß</div><div>hat gegessen</div><div><br /></div><div>есть</div>
<div>fliegen</div>	<div>flog</div><div>ist/hat geflogen</div><div><br /></div><div>летать</div>
<div>gehen</div>	<div>ging</div><div>ist gegangen</div><div><br /></div><div>идти</div>
<div>gießen</div>	<div>goss</div><div>hat gegossen</div><div><br /></div><div>лить</div>
<div>lesen</div>	<div>las</div><div>hat gelesen</div><div><br /></div><div>читать</div>
<div>mögen</div>	<div>mochte</div><div>hat gemocht</div><div><br /></div><div>хотеть</div>
<div>quellen</div>	<div>quoll</div><div>ist gequollen</div><div><br /></div><div>битьключом</div>
<div>saufen</div>	<div>soff</div><div>hat gesoffen</div><div><br /></div><div>пить, пьянствовать</div>
<div>schlagen</div>	<div>schlug</div><div>hat geschlagen</div><div><br /></div><div>бить</div>
<div>sein</div>	<div>war</div><div>ist gewesen</div><div><br /></div><div>быть</div>
<div>singen</div>	<div>sang</div><div>hat gesungen</div><div><br /></div><div>петь</div>
<div>treffen</div>	<div>traf</div><div>hat getroffen</div><div><br /></div><div>встречать</div>
<div>trinken</div>	<div>trank</div><div>hat getrunken</div><div><br /></div><div>пить</div>
<div>waschen</div>	<div>wusch</div><div>hat gewaschen</div><div><br /></div><div>мыть</div>
<div>weichen</div>	<div>wich</div><div>ist gewichen</div><div><br /></div><div>уступать</div>
<div>winden</div>	<div>wand</div><div>hat gewunden</div><div><br /></div><div>вить</div>
<div>wollen</div>	<div>wollte</div><div>hat gewollt</div><div><br /></div><div>хотеть</div>
<div>biegen</div>	<div>bog</div><div>hat gebogen</div><div><br /></div><div>гнуть</div>
<div>laden</div>	<div>lud</div><div>hat geladen</div><div><br /></div><div>грузить:приглашать</div>
<div>mißlingen</div>	<div>mißlang</div><div>ist mißlungen</div><div><br /></div><div>неудаваться</div>
<div>schallen</div>	<div>schallte(scholl)</div><div>hat geschallt (geschollen)</div><div><br /></div><div>звучать</div>
<div>sinken</div>	<div>sank</div><div>ist gesunken</div><div><br /></div><div>опускаться</div>
<div>treten</div>	<div>trat</div><div>ist/hat getreten</div><div><br /></div><div>ступать</div>
<div>fechten</div>	<div>focht</div><div>hat gefochten</div><div><br /></div><div>фехтовать</div>
<div>finden</div>	<div>fand</div><div>hat gefunden</div><div><br /></div><div>находить</div>
<div>gleichen</div>	<div>glich</div><div>hat geglichen</div><div><br /></div><div>походить</div>
<div>riechen</div>	<div>roch</div><div>hat gerochen</div><div><br /></div><div>нюхать</div>
<div>schwellen</div>	<div>schwoll</div><div>ist geschwollen</div><div><br /></div><div>пухнуть</div>
<div>schwingen</div>	<div>schwang</div><div>hat geschwungen</div><div><br /></div><div>махать</div>
<div>sprießen</div>	<div>sproß</div><div>ist gesprossen</div><div><br /></div><div>всходить</div>
<div>beginnen</div>	<div>begann</div><div>hat begonnen</div><div><br /></div><div>начинать</div>
<div>dürfen</div>	<div>durfte</div><div>hat gedurft</div><div><br /></div><div>мочь</div>
<div>fließen</div>	<div>floß</div><div>ist geflossen</div><div><br /></div><div>течь</div>
<div>können</div>	<div>konnte</div><div>hat gekonnt</div><div><br /></div><div>мочь</div>
<div>rinnen</div>	<div>rann</div><div>ist geronnen</div><div><br /></div><div>течь</div>
<div>schleifen</div>	<div>schliff</div><div>hat geschliffen</div><div><br /></div><div>точить</div>
<div>schwinden</div>	<div>schwand</div><div>ist geschwunden</div><div><br /></div><div>исчезать</div>
<div>ziehen</div>	<div>zog</div><div>ist/hat gezogen</div><div><br /></div><div>тащить</div>
<div>schmeißen</div>	<div>schmiß</div><div>hat geschmissen</div><div><br /></div><div>швырять</div>
<div>springen</div>	<div>sprang</div><div>ist gesprungen</div><div><br /></div><div>прыгать</div>
<div>bergen</div>	<div>barg</div><div>hat geborgen</div><div><br /></div><div>прятать</div>
<div>schmelzen</div>	<div>schmolz</div><div>ist/hat geschmolzen</div><div><br /></div><div>таять, расплавляться</div>
<div>schwören</div>	<div>schwur(schwor)</div><div>hat geschworen</div><div><br /></div><div>клясться</div>
<div>spinnen</div>	<div>spann</div><div>hat gesponnen</div><div><br /></div><div>прясть</div>